"filename", "language", "TypeScript", "JavaScript", "comment", "blank", "total"
"c:\Users\AlexanderB\Desktop\My Content\Projects\IsraelRePost\IsraelRePost\src\index.js", "JavaScript", 0, 18, 2, 9, 29
"c:\Users\AlexanderB\Desktop\My Content\Projects\IsraelRePost\IsraelRePost\src\test.js", "JavaScript", 0, 15, 8, 3, 26
"c:\Users\AlexanderB\Desktop\My Content\Projects\IsraelRePost\IsraelRePost\src\typescript\api-requests\BranchRequest.ts", "TypeScript", 169, 0, 28, 19, 216
"c:\Users\AlexanderB\Desktop\My Content\Projects\IsraelRePost\IsraelRePost\src\typescript\api-requests\DatesRequest.ts", "TypeScript", 91, 0, 1, 8, 100
"c:\Users\AlexanderB\Desktop\My Content\Projects\IsraelRePost\IsraelRePost\src\typescript\api-requests\ServicesRequest.ts", "TypeScript", 109, 0, 0, 9, 118
"c:\Users\AlexanderB\Desktop\My Content\Projects\IsraelRePost\IsraelRePost\src\typescript\api-requests\TimesRequest.ts", "TypeScript", 76, 0, 13, 12, 101
"c:\Users\AlexanderB\Desktop\My Content\Projects\IsraelRePost\IsraelRePost\src\typescript\api-requests\UserRequest.ts", "TypeScript", 78, 0, 1, 8, 87
"c:\Users\AlexanderB\Desktop\My Content\Projects\IsraelRePost\IsraelRePost\src\typescript\appointments-update\BranchAppointment.ts", "TypeScript", 90, 0, 59, 21, 170
"c:\Users\AlexanderB\Desktop\My Content\Projects\IsraelRePost\IsraelRePost\src\typescript\appointments-update\DatesNode.ts", "TypeScript", 114, 0, 40, 17, 171
"c:\Users\AlexanderB\Desktop\My Content\Projects\IsraelRePost\IsraelRePost\src\typescript\appointments-update\IApiRequestNode.ts", "TypeScript", 3, 0, 1, 1, 5
"c:\Users\AlexanderB\Desktop\My Content\Projects\IsraelRePost\IsraelRePost\src\typescript\appointments-update\ServicesNode.ts", "TypeScript", 105, 0, 40, 18, 163
"c:\Users\AlexanderB\Desktop\My Content\Projects\IsraelRePost\IsraelRePost\src\typescript\appointments-update\TimesNode.ts", "TypeScript", 57, 0, 18, 13, 88
"c:\Users\AlexanderB\Desktop\My Content\Projects\IsraelRePost\IsraelRePost\src\typescript\appointments-update\UserNode.ts", "TypeScript", 81, 0, 21, 15, 117
"c:\Users\AlexanderB\Desktop\My Content\Projects\IsraelRePost\IsraelRePost\src\typescript\atomic-counter\AbstractAtomicCounter.ts", "TypeScript", 42, 0, 51, 14, 107
"c:\Users\AlexanderB\Desktop\My Content\Projects\IsraelRePost\IsraelRePost\src\typescript\atomic-counter\AtomicCounter.ts", "TypeScript", 68, 0, 57, 24, 149
"c:\Users\AlexanderB\Desktop\My Content\Projects\IsraelRePost\IsraelRePost\src\typescript\atomic-counter\CountDepleted.ts", "TypeScript", 15, 0, 3, 5, 23
"c:\Users\AlexanderB\Desktop\My Content\Projects\IsraelRePost\IsraelRePost\src\typescript\atomic-counter\CountRemaining.ts", "TypeScript", 11, 0, 0, 4, 15
"c:\Users\AlexanderB\Desktop\My Content\Projects\IsraelRePost\IsraelRePost\src\typescript\atomic-counter\RequestCounter.ts", "TypeScript", 18, 0, 17, 7, 42
"c:\Users\AlexanderB\Desktop\My Content\Projects\IsraelRePost\IsraelRePost\src\typescript\atomic-counter\RequestsAllowed.ts", "TypeScript", 21, 0, 18, 8, 47
"c:\Users\AlexanderB\Desktop\My Content\Projects\IsraelRePost\IsraelRePost\src\typescript\common\Deley.ts", "TypeScript", 0, 0, 7, 1, 8
"c:\Users\AlexanderB\Desktop\My Content\Projects\IsraelRePost\IsraelRePost\src\typescript\common\GetRandomIntInclusive.ts", "TypeScript", 5, 0, 1, 1, 7
"c:\Users\AlexanderB\Desktop\My Content\Projects\IsraelRePost\IsraelRePost\src\typescript\common\ParseCookies.ts", "TypeScript", 18, 0, 1, 1, 20
"c:\Users\AlexanderB\Desktop\My Content\Projects\IsraelRePost\IsraelRePost\src\typescript\common\ReadCertificates.ts", "TypeScript", 0, 0, 6, 2, 8
"c:\Users\AlexanderB\Desktop\My Content\Projects\IsraelRePost\IsraelRePost\src\typescript\common\SimpleRandomChars.ts", "TypeScript", 9, 0, 0, 3, 12
"c:\Users\AlexanderB\Desktop\My Content\Projects\IsraelRePost\IsraelRePost\src\typescript\common\SplitBranchesArray.ts", "TypeScript", 12, 0, 0, 2, 14
"c:\Users\AlexanderB\Desktop\My Content\Projects\IsraelRePost\IsraelRePost\src\typescript\common\StringFieldExistNonEmpty.ts", "TypeScript", 6, 0, 0, 1, 7
"c:\Users\AlexanderB\Desktop\My Content\Projects\IsraelRePost\IsraelRePost\src\typescript\common\todays-date.ts", "TypeScript", 18, 0, 3, 1, 22
"c:\Users\AlexanderB\Desktop\My Content\Projects\IsraelRePost\IsraelRePost\src\typescript\common\urls.ts", "TypeScript", 3, 0, 0, 1, 4
"c:\Users\AlexanderB\Desktop\My Content\Projects\IsraelRePost\IsraelRePost\src\typescript\custom-parent\ACustomPPort.ts", "TypeScript", 0, 0, 36, 8, 44
"c:\Users\AlexanderB\Desktop\My Content\Projects\IsraelRePost\IsraelRePost\src\typescript\custom-parent\ACustomParentPort.ts", "TypeScript", 22, 0, 14, 8, 44
"c:\Users\AlexanderB\Desktop\My Content\Projects\IsraelRePost\IsraelRePost\src\typescript\custom-parent\ContinuesUpdatePPort.ts", "TypeScript", 17, 0, 4, 4, 25
"c:\Users\AlexanderB\Desktop\My Content\Projects\IsraelRePost\IsraelRePost\src\typescript\custom-parent\IpManagerParentPort.ts", "TypeScript", 14, 0, 1, 3, 18
"c:\Users\AlexanderB\Desktop\My Content\Projects\IsraelRePost\IsraelRePost\src\typescript\custom-worker\ACustomWorker.ts", "TypeScript", 25, 0, 14, 8, 47
"c:\Users\AlexanderB\Desktop\My Content\Projects\IsraelRePost\IsraelRePost\src\typescript\custom-worker\BranchUpdaterWorker.ts", "TypeScript", 11, 0, 3, 4, 18
"c:\Users\AlexanderB\Desktop\My Content\Projects\IsraelRePost\IsraelRePost\src\typescript\custom-worker\IpManagementWorker.ts", "TypeScript", 12, 0, 3, 4, 19
"c:\Users\AlexanderB\Desktop\My Content\Projects\IsraelRePost\IsraelRePost\src\typescript\elastic\BaseElastic.ts", "TypeScript", 256, 0, 39, 50, 345
"c:\Users\AlexanderB\Desktop\My Content\Projects\IsraelRePost\IsraelRePost\src\typescript\elastic\BranchModel.ts", "TypeScript", 237, 0, 29, 26, 292
"c:\Users\AlexanderB\Desktop\My Content\Projects\IsraelRePost\IsraelRePost\src\typescript\elastic\ErrorModel.ts", "TypeScript", 82, 0, 11, 15, 108
"c:\Users\AlexanderB\Desktop\My Content\Projects\IsraelRePost\IsraelRePost\src\typescript\elastic\elstClient.ts", "TypeScript", 0, 0, 576, 54, 630
"c:\Users\AlexanderB\Desktop\My Content\Projects\IsraelRePost\IsraelRePost\src\typescript\interfaces\IApiRequest.ts", "TypeScript", 11, 0, 0, 1, 12
"c:\Users\AlexanderB\Desktop\My Content\Projects\IsraelRePost\IsraelRePost\src\typescript\interfaces\IBranch.ts", "TypeScript", 64, 0, 1, 1, 66
"c:\Users\AlexanderB\Desktop\My Content\Projects\IsraelRePost\IsraelRePost\src\typescript\interfaces\IBranchQueryResponse.ts", "TypeScript", 0, 0, 9, 3, 12
"c:\Users\AlexanderB\Desktop\My Content\Projects\IsraelRePost\IsraelRePost\src\typescript\interfaces\api-responses\IGenericApiResponse.ts", "TypeScript", 18, 0, 0, 2, 20
"c:\Users\AlexanderB\Desktop\My Content\Projects\IsraelRePost\IsraelRePost\src\typescript\interfaces\api-responses\ILocationGetServices.ts", "TypeScript", 17, 0, 0, 1, 18
"c:\Users\AlexanderB\Desktop\My Content\Projects\IsraelRePost\IsraelRePost\src\typescript\interfaces\api-responses\ISearchAvailableDates.ts", "TypeScript", 6, 0, 0, 1, 7
"c:\Users\AlexanderB\Desktop\My Content\Projects\IsraelRePost\IsraelRePost\src\typescript\interfaces\api-responses\ISearchAvailableSlots.ts", "TypeScript", 3, 0, 0, 1, 4
"c:\Users\AlexanderB\Desktop\My Content\Projects\IsraelRePost\IsraelRePost\src\typescript\interfaces\api-responses\IUserCreateAnonymous.ts", "TypeScript", 13, 0, 0, 1, 14
"c:\Users\AlexanderB\Desktop\My Content\Projects\IsraelRePost\IsraelRePost\src\typescript\isreal-post-requests\PostBaseRequest.ts", "TypeScript", 119, 0, 4, 15, 138
"c:\Users\AlexanderB\Desktop\My Content\Projects\IsraelRePost\IsraelRePost\src\typescript\isreal-post-requests\PostDatesRequest.ts", "TypeScript", 65, 0, 12, 16, 93
"c:\Users\AlexanderB\Desktop\My Content\Projects\IsraelRePost\IsraelRePost\src\typescript\isreal-post-requests\PostServiceRequest.ts", "TypeScript", 82, 0, 12, 17, 111
"c:\Users\AlexanderB\Desktop\My Content\Projects\IsraelRePost\IsraelRePost\src\typescript\isreal-post-requests\PostTimesRequest.ts", "TypeScript", 55, 0, 12, 17, 84
"c:\Users\AlexanderB\Desktop\My Content\Projects\IsraelRePost\IsraelRePost\src\typescript\isreal-post-requests\PostUserRequest.ts", "TypeScript", 62, 0, 9, 15, 86
"c:\Users\AlexanderB\Desktop\My Content\Projects\IsraelRePost\IsraelRePost\src\typescript\middlewares\error-handler.ts", "TypeScript", 8, 0, 13, 5, 26
"c:\Users\AlexanderB\Desktop\My Content\Projects\IsraelRePost\IsraelRePost\src\typescript\proxy-management\ProxyCollection.ts", "TypeScript", 44, 0, 10, 11, 65
"c:\Users\AlexanderB\Desktop\My Content\Projects\IsraelRePost\IsraelRePost\src\typescript\proxy-management\SmartProxyCollection.ts", "TypeScript", 13, 0, 2, 4, 19
"c:\Users\AlexanderB\Desktop\My Content\Projects\IsraelRePost\IsraelRePost\src\typescript\proxy-management\WebShareCollection.ts", "TypeScript", 13, 0, 2, 4, 19
"c:\Users\AlexanderB\Desktop\My Content\Projects\IsraelRePost\IsraelRePost\src\typescript\puppeteer\pptr-browser.ts", "TypeScript", 115, 0, 2, 18, 135
"c:\Users\AlexanderB\Desktop\My Content\Projects\IsraelRePost\IsraelRePost\src\typescript\redis\BaseRedisQueue.ts", "TypeScript", 40, 0, 6, 11, 57
"c:\Users\AlexanderB\Desktop\My Content\Projects\IsraelRePost\IsraelRePost\src\typescript\redis\BranchesToProcess.ts", "TypeScript", 20, 0, 0, 7, 27
"c:\Users\AlexanderB\Desktop\My Content\Projects\IsraelRePost\IsraelRePost\src\typescript\redis\ProcessedBranches.ts", "TypeScript", 20, 0, 0, 7, 27
"c:\Users\AlexanderB\Desktop\My Content\Projects\IsraelRePost\IsraelRePost\src\typescript\redis\RedisTest.ts", "TypeScript", 30, 0, 15, 11, 56
"c:\Users\AlexanderB\Desktop\My Content\Projects\IsraelRePost\IsraelRePost\src\typescript\routes\AllBranches.ts", "TypeScript", 64, 0, 4, 7, 75
"c:\Users\AlexanderB\Desktop\My Content\Projects\IsraelRePost\IsraelRePost\src\typescript\routes\TestLab.ts", "TypeScript", 226, 0, 43, 30, 299
"c:\Users\AlexanderB\Desktop\My Content\Projects\IsraelRePost\IsraelRePost\src\typescript\routes\TimeSlots.ts", "TypeScript", 18, 0, 21, 9, 48
"c:\Users\AlexanderB\Desktop\My Content\Projects\IsraelRePost\IsraelRePost\src\typescript\scrape-multithreaded\BranchUpdater.ts", "TypeScript", 32, 0, 24, 12, 68
"c:\Users\AlexanderB\Desktop\My Content\Projects\IsraelRePost\IsraelRePost\src\typescript\scrape-multithreaded\CParentPort.ts", "TypeScript", 25, 0, 6, 8, 39
"c:\Users\AlexanderB\Desktop\My Content\Projects\IsraelRePost\IsraelRePost\src\typescript\scrape-multithreaded\CWorker.ts", "TypeScript", 31, 0, 13, 8, 52
"c:\Users\AlexanderB\Desktop\My Content\Projects\IsraelRePost\IsraelRePost\src\typescript\scrape-multithreaded\ContinuesUpdate.ts", "TypeScript", 106, 0, 63, 27, 196
"c:\Users\AlexanderB\Desktop\My Content\Projects\IsraelRePost\IsraelRePost\src\typescript\scrape-multithreaded\IpManager.ts", "TypeScript", 121, 0, 106, 38, 265
"c:\Users\AlexanderB\Desktop\My Content\Projects\IsraelRePost\IsraelRePost\src\typescript\scrape-multithreaded\ManageWorkers.ts", "TypeScript", 0, 0, 357, 36, 393
"c:\Users\AlexanderB\Desktop\My Content\Projects\IsraelRePost\IsraelRePost\src\typescript\scrape-multithreaded\Worker.ts", "TypeScript", 0, 0, 151, 18, 169
"c:\Users\AlexanderB\Desktop\My Content\Projects\IsraelRePost\IsraelRePost\src\typescript\scrape-multithreaded\branch-record-object\Branch.ts", "TypeScript", 0, 0, 97, 10, 107
"c:\Users\AlexanderB\Desktop\My Content\Projects\IsraelRePost\IsraelRePost\src\typescript\scrape-multithreaded\messages\HandleThreadMessages.ts", "TypeScript", 29, 0, 0, 7, 36
"c:\Users\AlexanderB\Desktop\My Content\Projects\IsraelRePost\IsraelRePost\src\typescript\scrape-multithreaded\requests-as-nodes\DatesNode.ts", "TypeScript", 0, 0, 88, 7, 95
"c:\Users\AlexanderB\Desktop\My Content\Projects\IsraelRePost\IsraelRePost\src\typescript\scrape-multithreaded\requests-as-nodes\INode.ts", "TypeScript", 0, 0, 8, 3, 11
"c:\Users\AlexanderB\Desktop\My Content\Projects\IsraelRePost\IsraelRePost\src\typescript\scrape-multithreaded\requests-as-nodes\ServicesNode.ts", "TypeScript", 0, 0, 95, 7, 102
"c:\Users\AlexanderB\Desktop\My Content\Projects\IsraelRePost\IsraelRePost\src\typescript\scrape-multithreaded\requests-as-nodes\TimesNode.ts", "TypeScript", 0, 0, 56, 5, 61
"c:\Users\AlexanderB\Desktop\My Content\Projects\IsraelRePost\IsraelRePost\src\typescript\scrape-multithreaded\requests-as-nodes\UserNode.ts", "TypeScript", 0, 0, 73, 8, 81
"c:\Users\AlexanderB\Desktop\My Content\Projects\IsraelRePost\IsraelRePost\src\typescript\scrape\FilterBranches.ts", "TypeScript", 43, 0, 2, 6, 51
"c:\Users\AlexanderB\Desktop\My Content\Projects\IsraelRePost\IsraelRePost\src\typescript\test\atomic-counter\BaseCounter.ts", "TypeScript", 63, 0, 0, 19, 82
"c:\Users\AlexanderB\Desktop\My Content\Projects\IsraelRePost\IsraelRePost\src\typescript\test\proxy-collection\testProxyObjects.ts", "TypeScript", 16, 0, 0, 3, 19
"c:\Users\AlexanderB\Desktop\My Content\Projects\IsraelRePost\IsraelRePost\src\typescript\test\suites\IsraelPostsAPIs.ts", "TypeScript", 88, 0, 4, 14, 106
"c:\Users\AlexanderB\Desktop\My Content\Projects\IsraelRePost\IsraelRePost\src\typescript\test\suites\RequestNodes.ts", "TypeScript", 54, 0, 4, 12, 70
"c:\Users\AlexanderB\Desktop\My Content\Projects\IsraelRePost\IsraelRePost\src\typescript\test\transferable\NodeDepth1.ts", "TypeScript", 9, 0, 4, 4, 17
"c:\Users\AlexanderB\Desktop\My Content\Projects\IsraelRePost\IsraelRePost\src\typescript\test\transferable\NodeDepth2.ts", "TypeScript", 10, 0, 0, 3, 13
"c:\Users\AlexanderB\Desktop\My Content\Projects\IsraelRePost\IsraelRePost\src\typescript\test\transferable\Root.ts", "TypeScript", 11, 0, 0, 3, 14
"Total", "-", 3659, 33, 2454, 885, 7031